1 1 1 1 1 1 1 1 1 1 1 1 1 1 1 1 1 1 1 1 
1 2 2 6 6 3 3 3 3 3 3 3 3 6 6 2 2 2 2 1
1 2 2 6 6 3 3 3 3 3 3 3 3 6 6 2 2 2 2 1
1 2 2 6 6 3 3 3 3 3 3 3 3 6 6 6 6 6 6 1
1 2 2 6 6 3 3 3 3 3 3 3 3 6 6 6 6 6 6 1
1 2 2 6 6 3 3 3 3 3 3 3 3 6 6 3 3 3 3 1
1 2 2 6 6 3 3 3 3 3 3 3 3 6 6 3 3 3 3 1
1 6 6 6 6 6 6 6 6 6 6 6 6 6 6 6 6 3 3 1
1 6 6 6 6 6 6 6 6 6 6 6 6 6 6 6 6 3 3 1
1 0 0 0 0 0 0 0 0 6 6 0 0 0 0 6 6 3 3 1
1 0 0 0 0 0 0 0 0 6 6 0 0 0 0 6 6 3 3 1
1 0 0 0 0 0 0 0 0 6 6 0 0 0 0 6 6 6 6 1
1 0 0 0 0 0 0 0 0 6 6 0 0 0 0 6 6 6 6 1
1 0 0 6 6 6 6 6 6 6 6 6 6 3 3 3 3 3 3 1
1 0 0 6 6 6 6 6 6 6 6 6 6 3 3 3 3 3 3 1
1 0 0 6 6 2 2 2 2 2 2 6 6 3 3 3 3 3 3 1
1 0 0 6 6 2 2 2 2 2 2 6 6 3 3 3 3 3 3 1
1 0 0 6 6 2 2 2 2 2 2 6 6 3 3 3 3 3 3 1
1 0 0 6 6 2 2 2 2 2 2 6 6 3 3 3 3 3 3 1 
1 1 1 1 1 1 1 1 1 1 1 1 1 1 1 1 1 1 1 1 

